R 1280 720 
NO ./srcs/eagle.xpm
SO ./srcs/greystone.xpm
WE ./srcs/mossy.xpm
EA ./srcs/wood.xpm
S ./srcs/pillar.xpm
F  234,123,8
C  32,124,34

      1111111111111111111
11111110000000002222000001
111111111111110000000S0001
11000000000000000000000111
11111111111111100000111111
111111000000000111111111
  1111100000000000011111
     111111002000001
        11111111111