R 1280 720
NO ./srcs/eagle.xpm
SO ./srcs/greystone.xpm
WE ./srcs/mossy.xpm
EA ./srcs/wood.xpm
S ./srcs/pillar.xpm
F  51,101,255
C  255,51,51

11111
1100 1
10001
11111