R 1280 720

NO ./textures/greystone.xpm
SO ./textures/bluestone.xpm
WE ./textures/redbrick.xpm
EA ./textures/colorstone.xpm
S ./textures/pillar.xpm
F  240,0,120
C  0,96,0


1111111111111111111111111111111111111111111111111111111111111
1000000000000000000000000000000000000000000000000000001111111
1000000000000000000000000000000000000000000000000000001
1000000000000000000000000000000000000000000000000000001111111
1000000000000000000000000000000000000000000000000000000000001
1000000000000000000000000000000000000000000000000000000000001
1000000000000000000000000000000000000000000000000000000000001
1000000000000000000000000000000000000000000000000000000000001
1000000000000000000000000000000000000000000000000000000000001
1000000000000000000000000000000000000000000000000000000000001
1000000000000000000000000000000000000000000000000000000000001
1000000000000000000000000000000000000000000000000000000000001
1000000000000000000000000000000000000000000000000000000000001
1000000000000000000000000000000000000000000000000000000000001   1111
10000000000000000000000000000001000000N0000000000000000000001   1001
1000000000000000000000000000000000000000000000000000000000001   1111
1000000000000000000000000000000002000000000000000000000000001
1000000000000000000000000000000000000000000000000000000000001
1000000000000000000000000000000001000000000000000000000000001
100000000000000000000000000000000N0000000000000000000000000010
1000000000000000000000000000000000000000000000000000000000001
1000000000000000000000000000000000000000000000000000000000001
1000000000000000000000000000000000000000000000000000000000001
1000000000000000000000000000000000000000000000000000000000001
1000000000000000000000000000000000000000000000000000000000001
1000000000000000000000000000000000000000000000000000000000001
1111111111111111111111111111111111111111111111111111111111111