R 1280 720
NO ./srcs/eagle.xpm
SO ./srcs/greystone.xpm
WE ./srcs/mossy.xpm
EA ./srcs/wood.xpm
S ./srcs/pillar.xpm
F  234,123,8
C  32,124,34

1111111111111111111111111111111111111111111111111111111111111
1000000000000000000000000000000000000000000000000000001111111
1000000000000000000000000000000000000000000000000000001
1000000000000000000000000000000000000000000000000000001111111
1000000000000000000000000000000000000000000000000000000000001
1000000000000000000000000000000000000000000000000000000000001
1000000000000000000000000000000000000000000000000000000000001
10000000000000000000000000000000000000000000000000000000000001
1000000000000000000000000000000000000000000000000000000000001
1000000000000000000000000000000000000000000000000000000000001
100000000000000000000000000000000000000000000000000000000001
1000000000000000000000000000000000000000000000000000000000001
1000000000000000000000000000000000000000000000000000000000001
1000000000000000000000000000000000000000000000000000000000001  
100000000000000010000000000000011000000000000000000000000001   
100000000000000000000011111100001000011111100000000000000001   
1000000000000000000000100001000010000000001000000000000000001
100000000000000000000010000111111000000000100000000000000001
10000000000000000000001000000000111000N0001000000000000000001
1000000000000000000000122222222210102000001000000000000000101
1000000000000000000000000000000000000000001000000000000000001
1000000000000000000000000000000100011111001000000000000000001
1000000000000000000000000000000100010001001000000000000000001
1000000000000000000000000000000111110001111000000000000000001
1000000000000000000000000000000000000000000000000000000000001
1111111111111111111111111111111111111111111111111111111111111