R 1280 720
NO ./map/textures/eagle.xpm
SO ./map/textures/greystone.xpm
WE ./map/textures/mossy.xpm
EA ./map/textures/wood.xpm
S ./map/textures/pillar.xpm
F  51,101,255
C  255,51,51

      1111111111111111111
11111110000000002222000001
111111111111110000000S0001
1000000000000000000000111
11111111111111100000111111
111111000000000111111111
  1111100000000000011111
     111111002000001
        1111111 111